1101000000
0100100100
0010001110
0111100100
0001110000
0000011100
0001110010
0011000110
0001110000
0011111100
