1111100000
0100000100
0010001110
0111100100
0001110000
0000011110
0001110010
0011000010
0001110000
0011111100
